whic	which
releses	releases
haemorrage	haemorrhage
preperations	preparations
dipthongs	diphthongs
embarass	embarrass
emmision	emission
unsubstanciated	unsubstantiated
restraunt	restaurant
religeous	religious
naieve	naive
probablly	probably
noticeing	noticing
originnally	originally
authorithy	authority
authobiographic	autobiographic
alreayd	already
tattooes	tattoos
recident	resident
manouverable	maneuverable
infilitrated	infiltrated
severley	severely
deteoriated	deteriorated
millenial	millennial
futhroc	futhark
atribute	attribute
mathmatically	mathematically
tendacy	tendency
alusion	allusion
financialy	financially
decribe	describe
aroud	around
tendancy	tendency
endevors	endeavors
mutiliated	mutilated
apprearance	appearance
unsuccessfull	unsuccessful
surley	surely
probelm	problem
sacrafice	sacrifice
sountrack	soundtrack
analogeous	analogous
recipiants	recipients
allign	align
carefull	careful
appartments	apartments
condidtion	condition
shouldnt	shouldn't
busineses	business
fourty	forty
harases	harasses
suop	soup
protrayed	portrayed
villin	villi
ocurrance	occurrence
homogeneized	homogenized
manouverability	maneuverability
ouevre	oeuvre
inconsistant	inconsistent
constaints	constraints
nusance	nuisance
apperance	appearance
histocompatability	histocompatibility
anwsered	answered
appology	apology
choosen	chosen
coordiantion	coordination
comissioning	commissioning
awya	away
seceed	secede
jaques	jacques
progrom	pogrom
controll	control
polysaccaride	polysaccharide
movment	movement
incorprates	incorporates
Palistian	Palestinian
offereings	offerings
hapen	happen
prominately	predominately
govenment	government
inteligence	intelligence
convertion	conversion
responsiblity	responsibility
deram	dram
restauration	restoration
decribed	described
adminstered	administered
medacine	medicine
scoll	scroll
desitned	destined
signifigantly	significantly
liasons	liaisons
recieved	received
equippment	equipment
vigeur	vigour
Champange	Champagne
referiang	referring
yatch	yacht
uncertainity	uncertainty
uncompetive	uncompetitive
activites	activities
dificulty	difficulty
facist	fascist
fisionable	fissionable
garantees	guarantees
aggreement	agreement
proccessing	processing
monts	months
manufatured	manufactured
extrememly	extremely
institue	institute
Brasillian	Brazilian
whn	when
scuptures	sculptures
chracter	character
moreso	more
provinicial	provincial
technolgy	technology
acadamy	academy
abundunt	abundant
includ	include
lmits	limits
instuments	instruments
Sionists	Zionists
unsucesfuly	unsuccessfully
liquify	liquefy
develpment	development
prophacy	prophecy
compensantion	compensation
correspondants	correspondents
agina	angina
delevopment	development
sucessful	successful
armistace	armistice
precedessor	predecessor
aleged	alleged
compability	compatibility
dicover	discover
wohle	whole
responce	response
compeitions	competitions
aggaravates	aggravates
irrelevent	irrelevant
exeedingly	exceedingly
visable	visible
reprtoire	repertoire
torpedos	torpedoes
Carmalite	Carmelite
surplanted	supplanted
enxt	next
turnk	turnkey
decomissioned	decommissioned
engieneers	engineers
destablized	destabilized
dissappear	disappear
commitee	committee
nontheless	nonetheless
profesion	profusion
shopkeeepers	shopkeepers
leage	league
scavanged	scavenged
alege	allege
proces	process
commuinications	communications
surrepetitious	surreptitious
reptition	repetition
mediciney	mediciny
proclaimation	proclamation
Sionist	Zionist
necesary	necessary
transformaton	transformation
unilateraly	unilaterally
precurser	precursor
ecidious	deciduous
imaginery	imaginary
hypocrit	hypocrite
emminently	eminently
resturaunt	restaurant
emmigrated	emigrated
ingenius	ingenious
consonent	consonant
lonelyness	loneliness
particualr	particular
aquitted	acquitted
distruction	destruction
accomodations	accommodations
proceding	preceding
adminstrate	administrate
extraterrestials	extraterrestrials
relpacement	replacement
finaly	finally
Phillipines	Philippines
enlargments	enlargements
similiar	similar
deteriate	deteriorate
emition	emission
protaganist	protagonist
alotted	allotted
hierachies	hierarchies
plesant	pleasant
misile	missile
halp	help
manouvers	manoeuvres
greif	grief
enourmously	enormously
hypocrasy	hypocrisy
herad	Hera
infilitrate	infiltrate
committe	committee
determinining	determining
Tolkein	Tolkien
archetectural	architectural
accomodation	accommodation
Hallowean	Halloween
earnt	earned
wille	will
sasy	says
undreground	underground
presumabely	presumably
controling	controlling
libguistics	linguistics
warantee	warranty
enviromentalist	environmentalist
hismelf	himself
sepulchure	sepulcher
philisopher	philosopher
transporation	transportation
dessigned	designed
dirived	derived
wirting	writing
volcanoe	volcano
inevitible	inevitable
architechtures	architectures
continous	continuous
tenacle	tentacle
releiver	reliever
priveliged	privileged
thast	that's
Palistinians	Palestinians
procede	precede
lonley	lonely
abilties	abilities
Sixtin	Sistine
univeristies	universities
lisense	licence
aiport	airport
hillarious	hilarious
exagerrated	exaggerated
insensative	insensitive
unsucessful	unsuccessful
succesful	successful
offred	offered
larrry	larry
esitmated	estimated
prestigous	prestigious
humerous	humerus
interm	interim
ganerate	generate
pedestrain	pedestrian
emision	emission
Farenheit	Fahrenheit
amalgomated	amalgamated
perjorative	pejorative
emperical	empirical
propperly	properly
neolitic	neolithic
recontructed	reconstructed
accomodates	accommodates
shiping	shipping
vrey	very
damenor	demeanor
appearences	appearances
exerternal	external
procedes	proceeds
extered	exerted
slowy	slowly
nuturing	nurturing
tormenters	tormentors
extermist	extremist
Pharoah	Pharaoh
manuever	manoeuvre
centruies	centuries
greatfully	gratefully
discribed	described
comission	commission
atheistical	atheistic
practicaly	practically
optomism	optimism
disproportiate	disproportionate
hindrence	hindrance
arrangments	arrangements
polute	pollute
enviornmental	environmental
unecessary	unnecessary
adres	address
endig	ending
cant	can't
forunner	forerunner
burried	buried
ocassioned	occasioned
gracefull	graceful
reccomendations	recommendations
gunanine	guanine
criterias	criteria
aforememtioned	aforementioned
themselfs	themselves
ocasionaly	occasionally
consistant	consistent
Phonecian	Phoenecian
suroundings	surroundings
liek	like
meaninng	meaning
calenders	calendars
suprizingly	surprisingly
geneology	genealogy
inventer	inventor
compatablities	compatibilities
anual	anal
habeus	habeas
performence	performance
gaurentees	guarantees
nkwo	know
studing	studying
recommedations	recommendations
unneccessary	unnecessary
severeal	several
philisophical	philosophical
ressemblance	resemblance
affilate	affiliate
consciouness	consciousness
Pucini	Puccini
leutenant	lieutenant
tourch	torch
pased	passed
turnk	trunk
comisioner	commissioner
himselv	himself
envolutionary	evolutionary
unmanouverable	unmaneuverable
knwo	know
embarassing	embarrassing
territorist	terrorist
dichtomy	dichotomy
decendants	descendants
billingualism	bilingualism
suceeded	succeeded
temparate	temperate
accoring	according
diversed	diverse
stopry	story
caligraphy	calligraphy
Britian	Britain
eventially	eventually
resemblence	resemblance
expeced	expected
dieties	deities
restaraunteurs	restaurateurs
conotations	connotations
definatly	definitely
intepretator	interpretor
recomend	recommend
incramentally	incrementally
Gothenberg	Gothenburg
regulaotrs	regulators
embarassment	embarrassment
efficently	efficiently
airporta	airports
fulfiled	fulfilled
durring	during
portraing	portraying
psuedo	pseudo
soudn	sound
conquerers	conquerors
incompatability	incompatibility
surrended	surrounded
auxilliaries	auxiliaries
startegy	strategy
nowe	now
harrassing	harassing
disolved	dissolved
asorbed	absorbed
theri	their
troling	trolling
aggreed	agreed
mispell	misspell
availble	available
poeoples	peoples
Europians	Europeans
spriritual	spiritual
conspiriator	conspirator
necesarily	necessarily
inctroduce	introduce
fatc	fact
successfull	successful
esle	else
allegedy	allegedly
efel	evil
perheaps	perhaps
constarnation	consternation
ressemble	resemble
thrid	third
misteryous	mysterious
geometrician	geometer
facinated	fascinated
deparment	department
coverted	coveted
whta	what
suprising	surprising
idesa	ideas
gae	Gael
attendent	attendant
nonsence	nonsense
popularaty	popularity
paralell	parallel
devolopement	development
consitutional	constitutional
incomptetent	incompetent
coverted	converted
seeked	sought
firts	first
concieved	conceived
considerd	considered
palce	place
artifically	artificially
busineses	businesses
mear	mare
rythim	rhythm
aggregious	egregious
eveyr	every
futher	further
distingished	distinguished
occassions	occasions
scientis	scientist
cannnot	cannot
grammaticaly	grammatically
receeding	receding
corrisponded	corresponded
segementation	segmentation
dicovered	discovered
soley	solely
enchancement	enhancement
siginificant	significant
corrispond	correspond
htis	this
magolia	magnolia
wupport	support
retreive	retrieve
adresable	addressable
toriodal	toroidal
accomadation	accommodation
expells	expels
liscense	licence
beleif	belief
resevoir	reservoir
ideosyncratic	idiosyncratic
auxillary	auxiliary
exerciese	exercises
Bernouilli	Bernoulli
anarchim	anarchism
persistance	persistence
disemination	dissemination
threee	three
annualy	annually
rougly	roughly
driectly	directly
proceding	proceeding
alcohal	alcohol
disapointing	disappointing
councellors	councillors
maintinaing	maintaining
dicussed	discussed
encryptiion	encryption
diea	idea
constituion	constitution
enviornments	environments
soudns	sounds
incarcirated	incarcerated
interbread	interbred
similiarity	similarity
similarily	similarly
spontanous	spontaneous
Guaduloupe	Guadeloupe
frequentily	frequently
occuring	occurring
htikn	think
agressor	aggressor
goverance	governance
addmission	admission
indviduals	individuals
refrence	reference
reigining	reigning
sufficent	sufficient
descisions	decisions
restauranteurs	restaurateurs
critising	criticising
surounding	surrounding
dominaton	domination
occassion	occasion
cartilidge	cartilage
manisfestations	manifestations
pronounched	pronounced
archimedian	archimedean
teached	taught
preminence	preeminence
prevelant	prevalent
colonizators	colonizers
signitories	signatories
milennia	millennia
abreviation	abbreviation
aquiring	acquiring
famoust	famous
manouver	manoeuvre
stoyr	story
insitution	institution
preceeds	precedes
sourth	south
comback	comeback
contendor	contender
approximitely	approximately
processer	processor
largst	largest
extrordinary	extraordinary
appropropiate	appropriate
attemt	attempt
iresistably	irresistibly
achivement	achievement
alliviate	alleviate
apprieciate	appreciate
asociated	associated
Galations	Galatians
essencial	essential
appealling	appalling
consumated	consummated
dicovery	discovery
sunglases	sunglasses
consolodate	consolidate
mccarthyst	mccarthyist
resssurecting	resurrecting
transcripting	transcribing
rabinnical	rabbinical
archtype	archetype
sincerley	sincerely
lible	liable
equivlalent	equivalent
volontary	voluntary
headquatered	headquartered
inbetween	between
baout	about
towrad	toward
poety	poetry
availible	available
lieved	lived
hasnt	hasn't
defendents	defendants
sucessfull	successful
ilogical	illogical
borke	broke
experianced	experienced
possiblility	possibility
alegience	allegiance
proceded	proceeded
paralelly	parallelly
mechandise	merchandise
hvea	have
vengence	vengeance
broacasted	broadcast
transcendant	transcendent
morroccan	moroccan
Israelies	Israelis
moent	moment
captued	captured
camoflage	camouflage
accademy	academy
manouverable	manoeuvrable
proccess	process
miliraty	military
meranda	Miranda
whant	want
densly	densely
beseiged	besieged
assoicate	associate
suposed	supposed
arised	arose
leaded	led
paralel	parallel
unchangable	unchangeable
boaut	bout
innoculated	inoculated
unrepentent	unrepentant
tempertaure	temperature
siezing	seizing
imagenary	imaginary
unoperational	nonoperational
changable	changeable
oposite	opposite
haviest	heaviest
concider	consider
accomodating	accommodating
responnsibilty	responsibility
doulbe	double
eclispe	eclipse
tounge	tongue
primatively	primitively
alchol	alcohol
Ihaca	Ithaca
imigrant	immigrant
quarantaine	quarantine
devels	delves
incompatablities	incompatibilities
stroy	story
permissable	permissible
persued	pursued
eminated	emanated
jeapardy	jeopardy
posion	poison
vegitable	vegetable
tyrany	tyranny
bodydbuilder	bodybuilder
consious	conscious
onot	note
interupt	interrupt
addres	adders
abundacies	abundances
approxamately	approximately
littel	little
reciever	receiver
commiting	committing
critisism	criticism
prominance	prominence
enviormental	environmental
counries	countries
originall	original
lerans	learns
ackward	awkward
presedential	presidential
signficiant	significant
introdued	introduced
ocasional	occasional
manufacturedd	manufactured
protruberances	protuberances
refering	referring
pretection	protection
metalurgy	metallurgy
guarentee	guarantee
electic	eclectic
therafter	thereafter
weaponary	weaponry
swaers	swears
vegitables	vegetables
addresed	addressed
excecuted	executed
speciallized	specialized
premeired	premiered
throught	thought
somene	someone
unwarrented	unwarranted
inablility	inability
sanctionning	sanctioning
livley	lively
misdameanors	misdemeanors
deterioriating	deteriorating
assasined	assassinated
seach	search
entitity	entity
Misouri	Missouri
dependancy	dependency
mysogyny	misogyny
housr	hours
elicided	elicited
repentent	repentant
preceed	precede
soilders	soldiers
provicial	provincial
attemts	attempts
avaliable	available
perseverence	perseverance
rulle	rule
vaieties	varieties
commericial	commercial
returnd	returned
labatory	laboratory
commemmorating	commemorating
studdy	study
consituted	constituted
personnell	personnel
banruptcy	bankruptcy
hydropobic	hydrophobic
verfication	verification
sorrounding	surrounding
dicovers	discovers
spects	aspects
ommision	omission
practicly	practically
consdiered	considered
effords	affords
apparant	apparent
bondary	boundary
opthamologist	ophthalmologist
oponent	opponent
stlye	style
poluting	polluting
progroms	pogroms
descripters	descriptors
definiton	definition
forbiden	forbidden
authoritiers	authorities
unfourtunately	unfortunately
desinations	destinations
heiroglyphics	hieroglyphics
culiminating	culminating
admitedly	admittedly
intutively	intuitively
anbd	and
abundancies	abundances
contravercial	controversial
withdrawl	withdrawal
unsuprising	unsurprising
Papanicalou	Papanicolaou
vengance	vengeance
referal	referral
incredable	incredible
grammer	grammar
Fransiscans	Franciscans
gramatically	grammatically
arund	around
stong	strong
stilus	stylus
Johanine	Johannine
acomplish	accomplish
muscels	muscles
prairy	prairie
marjority	majority
rememberable	memorable
fidn	find
alledge	allege
rythm	rhythm
rised	rose
levetated	levitated
critisizing	criticizing
agina	again
releive	relieve
sucessive	successive
surley	surly
priviledges	privileges
persuits	pursuits
refusla	refusal
yera	year
sytle	style
inspite	inspire
isnt	isn't
faciliate	facilitate
scholarstic	scholastic
naturual	natural
reconcilation	reconciliation
Yementite	Yemenite
juristictions	jurisdictions
similiarly	similarly
alcholic	alcoholic
stratagically	strategically
univeral	universal
origanaly	originally
expiditions	expeditions
cassowarry	cassowary
arbitarily	arbitrarily
puchasing	purchasing
concensus	consensus
ancestory	ancestry
censur	censor
cmo	com
psyhic	psychic
differentiatiations	differentiations
candadate	candidate
threatend	threatened
omited	omitted
exibition	exhibition
whereever	wherever
garanteed	guaranteed
offcers	officers
thnigs	things
assasinated	assassinated
sedereal	sidereal
archetect	architect
homogeneize	homogenize
overshaddowed	overshadowed
computarized	computerized
heirarchy	hierarchy
collegues	colleagues
descriibes	describes
scandanavia	Scandinavia
organim	organism
unsed	used
accomadates	accommodates
authobiography	autobiography
dispicable	despicable
comprable	comparable
propoganda	propaganda
chemcial	chemical
lieuenant	lieutenant
infrantryman	infantryman
attendents	attendants
comander	commander
mantained	maintained
comemoretion	commemoration
pricipal	principal
acheivements	achievements
critisize	criticise
labatory	lavatory
attaindre	attained
dissobediance	disobedience
fiels	phials
nessasarily	necessarily
perosnality	personality
potrayed	portrayed
comprimise	compromise
screenwrighter	screenwriter
exhalted	exalted
congresional	congressional
Russion	Russian
Saterdays	Saturdays
phylosophical	philosophical
thsi	this
subcatagory	subcategory
authoritive	authoritative
adressable	addressable
sucesful	successful
ocasioned	occasioned
crtical	critical
eearly	early
wroet	wrote
donig	doing
shoudl	should
dificulties	difficulties
cannister	canister
beatiful	beautiful
archetecturally	architecturally
sumary	summary
tath	that
alomst	almost
asssassans	assassins
manuevers	maneuvers
mounth	month
aniversary	anniversary
troups	troupes
refference	reference
sandwhich	sandwich
exicting	exciting
charistics	characteristics
misdemenor	misdemeanor
progessed	progressed
discribe	describe
versitilaty	versatility
recievers	receivers
importamt	important
unmanouverable	unmanoeuvrable
structual	structural
collaberative	collaborative
embarrased	embarrassed
supposingly	supposedly
cemetary	cemetery
pastural	pastoral
thigsn	things
inhabitans	inhabitants
excecute	execute
dimesnional	dimensional
klenex	kleenex
mucuous	mucous
itnroduced	introduced
incompatable	incompatible
dissagreement	disagreement
infilitration	infiltration
doctines	doctrines
wayword	wayward
durig	during
proseletyzing	proselytizing
rehersal	rehearsal
recieve	receive
descendands	descendants
neigbours	neighbours
thn	then
everthing	everything
consideres	considered
existant	existent
repsectively	respectively
atributes	attributes
amerliorate	ameliorate
possiblity	possibility
greatful	grateful
magasine	magazine
sepina	subpoena
feromone	pheromone
pleasent	pleasant
calander	colander
opression	oppression
dissobedience	disobedience
htere	here
addopt	adopt
harrassment	harassment
poisin	poison
lveo	love
posthomous	posthumous
orgin	origin
lonly	lonely
charasmatic	charismatic
symetrical	symmetrical
unilatreally	unilaterally
probabilaty	probability
loosing	losing
omlette	omelette
probablistic	probabilistic
refrences	references
vasall	vassal
hinderence	hindrance
venemous	venomous
exapansion	expansion
tkaes	takes
sucesion	succession
hydogen	hydrogen
commandoes	commandos
erested	erected
scaricity	scarcity
judisuary	judiciary
ninteenth	nineteenth
carachter	character
electricty	electricity
supressing	suppressing
Guadulupe	Guadalupe
representive	representative
oging	ogling
surrouded	surrounded
aquisition	acquisition
Morisette	Morissette
funtion	function
Japanes	Japanese
posesses	possesses
conquerd	conquered
formallize	formalize
beginnig	beginning
rhythim	rhythm
capible	capable
disobediant	disobedient
Godounov	Godunov
primative	primitive
impliment	implement
automonomous	autonomous
rwite	write
subsquent	subsequent
sucide	suicide
philospher	philosopher
councellor	councilor
definately	definitely
cornmitted	committed
offical	official
coputer	computer
specif	specify
specif	specific
begginings	beginnings
bandwith	bandwidth
suprised	surprised
unkown	unknown
higer	higher
meterologist	meteorologist
montains	mountains
reponse	response
privelege	privilege
methaphor	metaphor
wresters	wrestlers
vasalls	vassals
defendent	defendant
realtions	relations
elphant	elephant
senstive	sensitive
gutteral	guttural
dissobediant	disobedient
thign	thing
vetween	between
reacing	reaching
managable	manageable
wereabouts	whereabouts
deliberatly	deliberately
deram	dream
seceeded	seceded
senarios	scenarios
consdider	consider
charachter	character
smealting	smelting
promotted	promoted
sprech	speech
parrallelly	parallelly
apropriate	appropriate
villification	vilification
dispair	despair
protocal	protocol
procedings	proceedings
prominantly	prominently
volonteering	volunteering
exibitions	exhibitions
ytou	you
exagerating	exaggerating
accidently	accidentally
inaccessable	inaccessible
soluable	soluble
responibilities	responsibilities
hapened	happened
careing	caring
eyar	eyas
acquited	acquitted
conection	connection
themslves	themselves
inudstry	industry
ancilliary	ancillary
audeince	audience
siezed	sized
correposding	corresponding
governer	governor
deside	decide
suppliementing	supplementing
circut	circuit
posession	possession
reoccurrence	recurrence
postion	position
severly	severely
hypocracy	hypocrisy
pilgrimmages	pilgrimages
thsoe	those
forsaw	foresaw
tlaking	talking
vyer	very
sepulcre	sepulchre
negligable	negligible
memeber	member
provded	provided
adressing	addressing
ocassionaly	occasionally
Missisippi	Mississippi
violentce	violence
neigbour	neighbor
rigeur	rigor
misfourtunes	misfortunes
assoicated	associated
telelevision	television
wensday	Wednesday
additionaly	additionally
inmigrant	immigrant
gogin	Gauguin
instutions	intuitions
sppeches	speeches
infectuous	infectious
governmnet	government
attension	attention
inefficienty	inefficiently
coform	conform
clasically	classically
eceonomy	economy
tourch	touch
substracts	subtracts
orgin	organ
buring	burin
exploititive	exploitative
encylopedia	encyclopedia
playright	playwright
mathematican	mathematician
extint	extant
prepatory	preparatory
albiet	albeit
accelleration	acceleration
siezed	seized
parallely	parallelly
restaraunts	restaurants
spermatozoan	spermatozoon
commisions	commissions
pallete	palette
brillant	brilliant
soliliquy	soliloquy
yaching	yachting
unsucessfull	unsuccessful
plebicite	plebiscite
interational	international
infomation	information
distiction	distinction
electon	electron
illess	illness
cahracters	characters
churchs	churches
penisular	peninsular
differnt	different
hydropile	hydrophile
attened	attended
controvercial	controversial
santioned	sanctioned
lisence	license
entrepeneurs	entrepreneurs
multiplers	multipliers
nuculear	nuclear
decomposit	decompose
equivelent	equivalent
ocurred	occurred
pratice	practice
critising	criticizing
neccessities	necessities
envrionments	environments
irregardless	regardless
confids	confides
currenly	currently
octohedra	octahedra
alcoholical	alcoholic
sheat	sheet
conveinent	convenient
interchangably	interchangeably
ceratin	certain
Flemmish	Flemish
achived	achieved
nightime	nighttime
siezure	seizure
detailled	detailed
scinece	science
openess	openness
orginally	originally
adecuate	adequate
emminent	imminent
despiration	desperation
contritutions	contributions
valuble	valuable
embarassed	embarrassed
larg	large
abreviated	abbreviated
rininging	ringing
enviornmentalist	environmentalist
ammend	amend
sotyr	story
fianite	finite
gratuitious	gratuitous
kindergarden	kindergarten
relativly	relatively
understoon	understood
UnitesStates	UnitedStates
actualy	actually
succesfuly	successfully
receeded	receded
levetate	levitate
alchohol	alcohol
compatablity	compatibility
consicousness	consciousness
spred	spread
unfortunatley	unfortunately
loev	love
liscense	license
reccomended	recommended
cerimony	ceremony
possiblilty	possibility
specifiying	specifying
reponsible	responsible
gurantees	guarantees
comittee	committee
competance	competence
foward	forward
preceeded	preceded
competion	completion
cartdridge	cartridge
mariage	marriage
wasnt	wasn't
hesistant	hesitant
copmetitors	competitors
tendancies	tendencies
indefinitly	indefinitely
propmted	prompted
decomposits	decomposes
initation	initiation
agian	again
attaindre	attainder
comming	coming
fictious	fictitious
assocation	association
univeristy	university
Conneticut	Connecticut
launhed	launched
eletricity	electricity
accquainted	acquainted
commisioned	commissioned
communciation	communication
cartrige	cartridge
desgined	designed
sacrifical	sacrificial
nineth	ninth
bussiness	business
traditition	tradition
resistable	resistible
referrs	refers
charaterized	characterized
posseses	possesses
yuo	you
schedual	schedule
asume	assume
intertaining	entertaining
practioner	practitioner
volounteered	volunteered
freind	friend
signifigant	significant
adherance	adherence
atheneans	athenians
satelite	satellite
gaurentee	guarantee
algebraical	algebraic
archetecture	architecture
shineing	shining
Europian	European
stregth	strength
liekd	liked
excecution	execution
deparments	departments
consequeseces	consequences
commedic	comedic
symettric	symmetric
bewteen	between
exagerrate	exaggerate
marraige	marriage
wokr	work
legitmate	legitimate
inpolite	impolite
guerilla	guerrilla
carniverous	carnivorous
profesor	professor
compitent	competent
affilliate	affiliate
receving	receiving
cervial	cervical
constituants	constituents
auxillaries	auxiliaries
dispostion	disposition
peageant	pageant
imprioned	imprisoned
adminstrator	administrator
sucessfully	successfully
tust	trust
knwos	knows
enviorments	environments
journies	journeys
hwihc	which
awared	awarded
preriod	period
bombarment	bombardment
bretheren	brethren
assasinate	assassinate
challege	challenge
virutally	virtually
seperatism	separatism
indispensible	indispensable
attendence	attendance
agrieved	aggrieved
allthough	although
afficionado	aficionado
proffesion	profession
effulence	effluence
noteable	notable
becomeing	becoming
tyranies	tyrannies
humerous	humorous
aready	already
secceeded	seceded
guerrilas	guerrillas
dieing	dying
absorbtion	absorption
thier	their
basicly	basically
reicarnation	reincarnation
Celcius	Celsius
snese	sneeze
comisioning	commissioning
reccuring	recurring
storise	stories
devistating	devastating
compatiable	compatible
hydropilic	hydrophilic
konws	knows
huminoid	humanoid
unlikey	unlikely
apon	apron
priveledges	privileges
sufferring	suffering
evidentally	evidently
acceptible	acceptable
indisputibly	indisputably
layed	laid
substace	substance
obession	obsession
nmae	name
beggins	begins
montanous	mountainous
applicaiton	application
reliablity	reliability
lazyness	laziness
decomposited	decomposed
strikely	strikingly
subterranian	subterranean
numberous	numerous
soverign	sovereign
sufficently	sufficiently
undoubtely	undoubtedly
overwelming	overwhelming
inflamation	inflammation
devestated	devastated
belives	believes
unconcious	unconscious
parralel	parallel
hydropobe	hydrophobe
carmel	caramel
occurrance	occurrence
concidering	considering
Cincinnatti	Cincinnati
saveing	saving
htink	think
onot	not
consituency	constituency
councellor	counselor
remenicent	reminiscent
breakthroughts	breakthroughs
submachne	submachine
nkow	know
Cincinatti	Cincinnati
incompetance	incompetence
consorcium	consortium
statememts	statements
perphas	perhaps
opthalmology	ophthalmology
potatos	potatoes
volonteered	volunteered
mataphysical	metaphysical
assualt	assault
qutie	quiet
thikning	thinking
wardobe	wardrobe
unplesant	unpleasant
facillitate	facilitate
dimentional	dimensional
peripathetic	peripatetic
woudl	would
unballance	unbalance
reciepents	recipients
influencial	influential
accension	accession
originall	originally
untill	until
protaganists	protagonists
nucular	nuclear
suprisingly	surprisingly
penatly	penalty
succedded	succeeded
contraversy	controversy
appearence	appearance
preverse	perverse
adress	address
speciallized	specialised
Cataline	Catalina
caluculated	calculated
pertubations	perturbations
sterotypes	stereotypes
rocord	record
assassintation	assassination
neigbouring	neighbouring
cassawory	cassowary
propietary	proprietary
ressembled	resembled
comissions	commissions
unusuable	unusable
dispite	despite
vell	well
refridgerator	refrigerator
symetry	symmetry
privledge	privilege
ellected	elected
coorperation	cooperation
ecomonic	economic
humurous	humorous
iritated	irritated
beleagured	beleaguered
realy	really
cumulatative	cumulative
monestary	monetary
proprietory	proprietary
emnity	enmity
unsed	unused
promiscous	promiscuous
posessed	possessed
preferrably	preferably
proximty	proximity
adquires	acquires
chalenging	challenging
strengtened	strengthened
suposes	supposes
apenines	Apennines
strenghen	strengthen
successully	successfully
youself	yourself
ocasionally	occasionally
consentrate	concentrate
unsuprizing	unsurprising
translater	translator
archiac	archaic
polinators	pollinators
descibed	described
seguoys	segues
imigrant	emigrant
derogitory	derogatory
excelent	excellent
wrok	work
archaoelogy	archeology
clera	clear
beng	being
resignement	resignment
embargos	embargoes
vaccum	vacuum
divison	division
valetta	valletta
northereastern	northeastern
equilibrum	equilibrium
abondons	abandons
crucifiction	crucifixion
representives	representatives
rewriet	rewrite
disctinction	distinction
opthalmic	ophthalmic
occassional	occasional
tremelos	tremolos
chemestry	chemistry
caracterized	characterized
adminstrative	administrative
polical	political
hten	the
uninterruped	uninterrupted
traditionaly	traditionally
backrounds	backgrounds
ommitted	omitted
atain	attain
youseff	yousef
reacll	recall
initally	initially
resteraunts	restaurants
extradiction	extradition
souvenier	souvenir
banannas	bananas
octohedral	octahedral
requirment	requirement
medeival	medieval
inteligent	intelligent
dyas	dryas
establising	establishing
offcially	officially
anual	annual
howver	however
workststion	workstation
equivilant	equivalent
toghether	together
iresistible	irresistible
cencus	census
deffensively	defensively
priveleged	privileged
syrap	syrup
surprized	surprised
herad	heard
metamorphysis	metamorphosis
doccuments	documents
villian	villain
launchs	launch
anonimity	anonymity
substracting	subtracting
realsitic	realistic
somtimes	sometimes
implimented	implemented
startegic	strategic
wnated	wanted
villin	villain
mischeivous	mischievous
sucessfuly	successfully
muscels	mussels
liuke	like
manuever	maneuver
beneficary	beneficiary
aircrafts	aircraft
temprary	temporary
preiod	period
puritannical	puritanical
diphtong	diphthong
pregancies	pregnancies
reversable	reversible
commision	commission
experiance	experience
volounteer	volunteer
discribes	describes
intial	initial
tyhe	they
progroms	programs
debateable	debatable
fouth	fourth
uninterupted	uninterrupted
develope	develop
acomplishments	accomplishments
guarenteed	guaranteed
millon	million
physicaly	physically
comparision	comparison
harrasses	harassed
intered	interred
indipendent	independent
apperances	appearances
averageed	averaged
beggining	beginning
dieing	dyeing
gae	game
ackward	backward
ensconsed	ensconced
coururier	couturier
maintance	maintenance
marketting	marketing
officals	officials
betwen	between
doccumented	documented
eyars	years
simpley	simply
eyars	eyas
russina	Russian
rhythem	rhythm
quizes	quizzes
asign	assign
refrers	refers
triguered	triggered
irresistably	irresistibly
witht	with
emphysyma	emphysema
Morrisette	Morissette
payed	paid
reconized	recognized
unneccesarily	unnecessarily
Phillipine	Philippine
disctinctive	distinctive
coudl	cloud
hsitorians	historians
omre	more
sponser	sponsor
yeild	yield
storeis	stories
indigineous	indigenous
competative	competitive
idealogies	ideologies
Missisipi	Mississippi
calaber	caliber
officialy	officially
transcendance	transcendence
clincial	clinical
baceause	because
accidentaly	accidentally
terroist	terrorist
wholey	wholly
idaes	ideas
clinicaly	clinically
fleed	fled
coverted	covered
impedence	impedance
throughly	thoroughly
entaglements	entanglements
centruy	century
orignally	originally
calander	calendar
eleminated	eliminated
consenquently	consequently
diosese	diocese
resembes	resembles
relized	realized
watn	want
alse	else
sucesfully	successfully
probaly	probably
trustworthyness	trustworthiness
consiciousness	consciousness
pursuaded	persuaded
Formalhaut	Fomalhaut
goverment	government
unahppy	unhappy
passerbys	passersby
Mediteranean	Mediterranean
poulations	populations
vigeur	vigueur
munnicipality	municipality
reciept	receipt
suceeding	succeeding
crticised	criticised
posess	possess
electon	election
lenght	length
perogative	prerogative
agregates	aggregates
muder	murder
comisions	commissions
headquater	headquarter
essentialy	essentially
avalable	available
decompositing	decomposing
secretery	secretary
religous	religious
millenialism	millennialism
propostion	proposition
occurrances	occurrences
vincinity	vicinity
sponzored	sponsored
pronounciation	pronunciation
consonents	consonants
rela	real
realyl	really
fomr	form
tahn	than
Carthagian	Carthaginian
circumsicion	circumcision
elction	election
geneologies	genealogies
pamflet	pamphlet
unuseable	unusable
penninsula	peninsula
manufaturing	manufacturing
autoctonous	autochthonous
originaly	originally
agin	again
todya	today
hygeine	hygiene
iresistibly	irresistibly
comisioned	commissioned
acquiantences	acquaintances
analitic	analytic
nestin	nesting
cervial	servile
acordingly	accordingly
eigth	eighth
reasearch	research
claerly	clearly
peotry	poetry
epsiode	episode
desireable	desirable
maintenence	maintenance
multicultralism	multiculturalism
Juadaism	Judaism
beleiving	believing
consulant	consultant
peristent	persistent
realitvely	relatively
rendezous	rendezvous
casion	caisson
lukid	likud
aledges	alleges
morrocco	morocco
boaut	boat
overwheliming	overwhelming
archaology	archaeology
preceeding	preceding
effords	efforts
aquainted	acquainted
planation	plantation
eigth	eight
millepede	millipede
ressemblence	resemblance
missle	missile
swiming	swimming
rhymme	rhyme
Massachussetts	Massachusetts
cpoy	copy
scientifc	scientific
beleive	believe
acceptence	acceptance
privilage	privilege
athiesm	atheism
desparate	disparate
provisiosn	provision
architechturally	architecturally
discontentment	discontent
intergrated	integrated
commited	committed
conserning	concerning
crusies	cruises
assasins	assassins
Yementite	Yemeni
ditributed	distributed
personel	personnel
concious	conscious
resurecting	resurrecting
exliled	exiled
orginal	original
achievment	achievement
indisputible	indisputable
gaurd	gourd
sheild	shield
Heidelburg	Heidelberg
sufferage	suffrage
metalurgic	metallurgic
siezing	sizing
repentence	repentance
purposedly	purposely
aquiantance	acquaintance
propogates	propagates
probalibity	probability
assit	assist
whants	wants
muscicians	musicians
spendour	splendour
asphyxation	asphyxiation
paranthesis	parenthesis
anthromorphization	anthropomorphization
idiosyncracy	idiosyncrasy
taxanomy	taxonomy
twon	town
rigeur	rigueur
helpped	helped
androgenous	androgynous
repeteadly	repeatedly
regluar	regular
neccessary	necessary
todays	today's
adn	and
authorative	authoritative
permenant	permanent
iminent	immanent
presense	presence
tiome	tome
copywrite	copyright
availablity	availability
catterpilars	caterpillars
intelectual	intellectual
conected	connected
politicans	politicians
againnst	against
becomming	becoming
varations	variations
progrom	program
catterpilar	caterpillar
dissappointed	disappointed
usefull	useful
scholarhip	scholarship
phenomenonal	phenomenal
mkaes	makes
suceeds	succeeds
kwno	know
remembrence	remembrance
minature	miniature
conspiracys	conspiracies
goign	going
addresing	addressing
perade	parade
manouvers	maneuvers
empirial	empirical
demolision	demolition
simmilar	similar
pantomine	pantomime
resistence	resistance
correponding	corresponding
siezures	seizures
anulled	annulled
peronal	personal
omision	omission
adressed	addressed
recieving	receiving
emblamatic	emblematic
hwile	while
casulaties	casualties
syncronization	synchronization
manouverability	manoeuvrability
unnecesary	unnecessary
insectiverous	insectivorous
beligum	belgium
talekd	talked
tommorrow	tomorrow
indictement	indictment
imense	immense
suspention	suspension
alwasy	always
heathy	healthy
arround	around
tranformed	transformed
flourescent	fluorescent
competion	competition
disagreeed	disagreed
accomadating	accommodating
moil	mohel
tkae	take
noncombatents	noncombatants
suprizing	surprising
iritable	irritable
oportunity	opportunity
menally	mentally
mamalian	mammalian
gnawwed	gnawed
bcak	back
affort	effort
sheat	sheath
auromated	automated
afficianados	aficionados
asthetical	aesthetical
sepulchure	sepulchre
variey	variety
sattelite	satellite
refect	reflect
hieroglph	hieroglyph
addressess	addresses
ammused	amused
thast	that
sucesfuly	successfully
eraticly	erratically
alsot	also
posessing	possessing
contempory	contemporary
Guaduloupe	Guadalupe
fomed	formed
enourmous	enormous
nowdays	nowadays
alchoholic	alcoholic
definate	definite
idaeidae	idea
translaters	translators
influented	influenced
strenght	strength
neccesary	necessary
technnology	technology
proffesed	professed
accompanyed	accompanied
contempoary	contemporary
paitience	patience
iminent	imminent
opose	oppose
vyre	very
priviledge	privilege
threatning	threatening
vriety	variety
gaurd	guard
fertily	fertility
harrases	harasses
mackeral	mackerel
dependant	dependent
apolegetics	apologetics
benifits	benefits
metaphoricial	metaphorical
autority	authority
prooved	proved
cleareance	clearance
cententenial	centennial
engeneering	engineering
explotation	exploitation
peculure	peculiar
costitution	constitution
speices	species
sponsered	sponsored
unrepetent	unrepentant
coucil	council
ironicly	ironically
saught	sought
metalic	metallic
lisence	licence
signifantly	significantly
cant	cannot
despatched	dispatched
recomending	recommending
Malcom	Malcolm
independece	independence
sturcture	structure
backgorund	background
apon	upon
happenned	happened
pomegranite	pomegranate
auxilary	auxiliary
desintegration	disintegration
negotation	negotiation
suprize	surprise
autochtonous	autochthonous
clasical	classical
helpfull	helpful
archaology	archeology
ethnocentricm	ethnocentrism
inocence	innocence
Lybia	Libya
possesing	possessing
sensure	censure
follwoing	following
runnung	running
combanations	combinations
oppenly	openly
doens	does
occurence	occurrence
dael	dahl
dupicate	duplicate
satrical	satirical
shaddow	shadow
furuther	further
thru	through
naturely	naturally
useing	using
fiel	phial
exoskelaton	exoskeleton
equitorial	equatorial
comissioned	commissioned
literture	literature
abilty	ability
metalurgical	metallurgical
neccesarily	necessarily
shamen	shaman
torpeados	torpedoes
disaproval	disapproval
eratically	erratically
pinoneered	pioneered
archaoelogy	archaeology
adhearing	adhering
doign	doing
opthalmologist	ophthalmologist
unsurprized	unsurprised
misdemenors	misdemeanors
inumerable	enumerable
crockodiles	crocodiles
catholocism	catholicism
engeneer	engineer
carismatic	charismatic
accross	across
warrriors	warriors
gae	gale
anounced	announced
agression	aggression
fluorish	flourish
leran	learn
improvments	improvements
unforgetable	unforgettable
inital	initial
seperated	separated
hieroglphs	hieroglyphs
transcripting	transcription
amendmant	amendment
marrtyred	martyred
surreptious	surreptitious
eles	eels
anytying	anything
exeptional	exceptional
indespensable	indispensable
emphaised	emphasised
volonteers	volunteers
eyasr	years
parellels	parallels
indipendently	independently
unchallengable	unchallengeable
oposition	opposition
provacative	provocative
recieves	receives
postive	positive
erested	arrested
rigeur	rigour
faciliated	facilitated
procedger	procedure
penerator	penetrator
fedreally	federally
succesion	succession
symetrically	symmetrically
sattelites	satellites
heridity	heredity
buoancy	buoyancy
imigrated	immigrated
wiull	will
predicatble	predictable
recivership	receivership
articel	article
noveau	nouveau
wiew	view
dissapearing	disappearing
acheiving	achieving
primarly	primarily
instade	instead
nto	not
partialy	partially
reportadly	reportedly
fucntion	function
automibile	automobile
antartic	antarctic
cerimonies	ceremonies
authorites	authorities
Nullabour	Nullarbor
fromed	formed
surrouding	surrounding
campain	campaign
iwth	with
saxaphone	saxophone
cannotations	connotations
linnaena	linnaean
devided	divided
comminication	communication
incompatiblity	incompatibility
docrines	doctrines
sevice	service
fightings	fighting
proceded	preceded
electricly	electrically
offically	officially
fiercly	fiercely
ressurected	resurrected
strenghening	strengthening
calulated	calculated
laguages	languages
Napoleonian	Napoleonic
enameld	enameled
relected	reelected
constatn	constant
conjuction	conjunction
extentions	extensions
rechargable	rechargeable
aginst	against
compatable	compatible
harasment	harassment
triology	trilogy
uncontitutional	unconstitutional
athiest	atheist
completelyl	completely
bellweather	bellwether
transistion	transition
quinessential	quintessential
simplier	simpler
ethose	ethos
concidered	considered
mysef	myself
appenines	apennines
devestating	devastating
reproducable	reproducible
exludes	excludes
journied	journeyed
equilibium	equilibrium
territoy	territory
morgage	mortgage
alowing	allowing
reminsicent	reminiscent
inadquate	inadequate
addtional	additional
acknowldeged	acknowledged
airbourne	airborne
firts	flirts
continously	continuously
survivied	survived
pronouced	pronounced
emiting	emitting
calulate	calculate
presumibly	presumably
intutive	intuitive
particularily	particularly
Habsbourg	Habsburg
extremeophile	extremophile
imagin	imagine
critisize	criticize
confidental	confidential
lible	libel
valueable	valuable
abandonned	abandoned
populer	popular
ceratin	keratin
calander	calender
strictist	strictest
levle	level
disatisfaction	dissatisfaction
refernces	references
troup	troupe
qtuie	quite
muncipalities	municipalities
carcas	Caracas
resturant	restaurant
beween	between
seperating	separating
wass	was
effeciency	efficiency
lastr	last
asside	aside
resistent	resistant
communites	communities
milion	million
televsion	television
befoer	before
apparantly	apparently
dael	deal
convienient	convenient
pilgrimmage	pilgrimage
aledged	alleged
electrial	electrical
proove	prove
fomr	from
meerkrat	meerkat
possibilty	possibility
decidely	decidedly
Buddah	Buddha
sould	sold
anihilation	annihilation
parrallell	parallel
incunabla	incunabula
architectual	architectural
emprisoned	imprisoned
emminent	eminent
sqaure	square
dectect	detect
descuss	discuss
archaelogy	archaeology
instuction	instruction
transfering	transferring
beaurocracy	bureaucracy
condamned	condemned
demostration	demonstration
sucessor	successor
acheivement	achievement
essentual	essential
privelige	privilege
artice	article
tjpanishad	upanishad
oppinion	opinion
exchanching	exchanging
perenially	perennially
usally	usually
encouraing	encouraging
conciously	consciously
glight	flight
occassionaly	occasionally
extemely	extremely
mroe	more
benificial	beneficial
restaraunteur	restaurateur
personel	personal
suseptable	susceptible
seperately	separately
imigration	immigration
primordal	primordial
coururier	courier
acheive	achieve
referrence	reference
vigourous	vigorous
sergent	sergeant
poltical	political
modle	model
enforceing	enforcing
pasttime	pastime
gauranteed	guaranteed
mkae	make
surveyer	surveyor
incompatabilities	incompatibilities
refedendum	referendum
hwole	whole
miliary	military
quitted	quit
honory	honorary
chemicaly	chemically
higest	highest
becamae	became
hierarcy	hierarchy
devasted	devastated
duting	during
peopel	people
soem	some
philisophy	philosophy
souveniers	souvenirs
undesireable	undesirable
illegimacy	illegitimacy
unneccessarily	unnecessarily
subsidary	subsidiary
cerimonial	ceremonial
argubly	arguably
pseudononymous	pseudonymous
sorceror	sorcerer
graet	great
familliar	familiar
execising	exercising
decieved	deceived
stiring	stirring
dissarray	disarray
weild	wild
exampt	exempt
meranda	veranda
skateing	skating
emmited	emitted
wehn	when
misdameanor	misdemeanor
satisfactority	satisfactorily
exressed	expressed
instatance	instance
wnat	want
increadible	incredible
comdemnation	condemnation
Nazereth	Nazareth
unforgiveable	unforgivable
phenomonon	phenomenon
wordlwide	worldwide
varient	variant
performes	performed
emited	emitted
cpoy	coy
publicaly	publicly
Jospeh	Joseph
imcomplete	incomplete
improvision	improvisation
beggin	begging
amatuer	amateur
trafic	traffic
conquerer	conqueror
tast	taste
spoace	space
prohabition	prohibition
exelent	excellent
radiactive	radioactive
palce	palace
inctroduced	introduced
levetates	levitates
minstry	ministry
Phillippines	Philippines
indpendently	independently
popoulation	population
critisized	criticised
assitant	assistant
eyar	year
futhroc	futhorc
amking	making
reconaissance	reconnaissance
disiplined	disciplined
Carribbean	Caribbean
incidentially	incidentally
decendent	descendant
civillian	civilian
wendsay	Wednesday
critisisms	criticisms
buring	during
imigrated	emigrated
infinit	infinite
excellance	excellence
ususally	usually
committment	commitment
prespective	perspective
maltesian	Maltese
extint	extinct
surveill	surveil
approachs	approaches
oppononent	opponent
prefering	preferring
documenatry	documentary
casulaty	casualty
alligned	aligned
mathmatician	mathematician
heros	heroes
aledge	allege
immitating	imitating
arangement	arrangement
arrangment	arrangement
agreing	agreeing
complier	compiler
mohammedans	muslims
capturd	captured
surounds	surrounds
retalitation	retaliation
comiting	committing
hosited	hoisted
withdrawl	withdraw
shiped	shipped
deriviated	derived
acheivments	achievements
tghe	the
stablility	stability
konw	know
poluted	polluted
professer	professor
harassement	harassment
thikning	thickening
pasengers	passengers
beggin	begin
enviornment	environment
carcas	carcass
sheat	cheat
assymetric	asymmetric
agre	agree
xenophoby	xenophobia
resticted	restricted
inclreased	increased
succceeded	succeeded
rococco	rococo
disenchanged	disenchanted
conserned	concerned
excecuting	executing
hertzs	hertz
errupted	erupted
broady	broadly
mudering	murdering
containes	contains
particually	particularly
acknowledgeing	acknowledging
finacial	financial
autor	author
adressing	dressing
reccommending	recommending
recepients	recipients
decideable	decidable
desctruction	destruction
disparingly	disparagingly
headquaters	headquarters
quicklyu	quickly
decribes	describes
acheives	achieves
phenomonenon	phenomenon
likelyhood	likelihood
substracted	subtracted
foundaries	foundries
effecient	efficient
attrocities	atrocities
achive	archive
breif	brief
montypic	monotypic
possition	position
appologies	apologies
questonable	questionable
Gottleib	Gottlieb
dael	dial
relatiopnship	relationship
cementary	cemetery
becouse	because
absense	absence
bombardement	bombardment
inprisonment	imprisonment
unsurprizing	unsurprising
comited	committed
maintioned	mentioned
useage	usage
hvaing	having
extraterrestial	extraterrestrial
performes	performs
ommitting	omitting
inagurated	inaugurated
ocassionally	occasionally
existance	existence
haev	have
prominately	prominently
immitate	imitate
restauraunt	restaurant
withing	within
wiht	with
inheritage	inheritance
allready	already
villin	villein
surrepetitiously	surreptitiously
scaleable	scalable
negociations	negotiations
alledged	alleged
profesion	profession
appeareance	appearance
rediculous	ridiculous
adventrous	adventurous
hten	then
unavailible	unavailable
Tuscon	Tucson
implamenting	implementing
unilatreal	unilateral
acquaintence	acquaintance
unforetunately	unfortunately
Enlish	enlist
penisula	peninsula
desktiop	desktop
calculs	calculus
personell	personnel
annoints	anoints
detatched	detached
foudn	found
thna	than
usualy	usually
estabishes	establishes
missonary	missionary
occurr	occur
atributed	attributed
enviormentally	environmentally
disover	discover
convenant	covenant
crystalisation	crystallisation
pursuade	persuade
indutrial	industrial
effeciently	efficiently
poweful	powerful
tiome	time
occour	occur
wholy	wholly
strat	strata
knowlegeable	knowledgeable
swaer	swear
independant	independent
constanly	constantly
arguement	argument
synonomous	synonymous
foreward	foreword
eratic	erratic
descision	decision
corrispondants	correspondents
startegies	strategies
managment	management
formost	foremost
recrod	record
indpendent	independent
perfomers	performers
rarified	rarefied
varity	variety
judical	judicial
wheras	whereas
manuver	maneuver
Queenland	Queensland
relitavely	relatively
membranaphone	membranophone
developement	development
misterious	mysterious
Juadism	Judaism
recipiant	recipient
cacuses	caucuses
monestary	monastery
surrundering	surrendering
ministery	ministry
caluclate	calculate
monestaries	monasteries
atempting	attempting
divice	device
sinse	since
controvercy	controversy
omniverously	omnivorously
hemmorhage	hemorrhage
seperates	separates
blessure	blessing
suphisticated	sophisticated
reedeming	redeeming
tyrranies	tyrannies
propper	proper
enviromentally	environmentally
artillary	artillery
inaguration	inauguration
adminstration	administration
acused	accused
visably	visibly
taxanomic	taxonomic
dissapear	disappear
derivitive	derivative
inheritage	heritage
soliders	soldiers
alltogether	altogether
flawess	flawless
omniverous	omnivorous
competant	competent
harrased	harassed
indentical	identical
chuch	church
examinated	examined
tihs	this
gaurantees	guarantees
vacinity	vicinity
powerfull	powerful
suseptible	susceptible
emmitting	emitting
inaugures	inaugurates
remenant	remnant
froniter	frontier
dissappears	disappears
immitator	imitator
harased	harassed
univesities	universities
weas	was
diety	deity
druming	drumming
weilded	wielded
vegatarian	vegetarian
configureable	configurable
seaches	searches
prarie	prairie
througout	throughout
assasin	assassin
hieght	height
transmissable	transmissible
ethose	those
requred	required
jouney	journey
adquire	acquire
breakthough	breakthrough
Guadulupe	Guadeloupe
gridles	griddles
phenomenonly	phenomenally
achivements	achievements
comandos	commandos
noticible	noticeable
fortelling	foretelling
acomplished	accomplished
buisness	business
recquired	required
seceeded	succeeded
sherif	sheriff
reciding	residing
repid	rapid
assoicates	associates
stornegst	strongest
agianst	against
exemple	example
fimilies	families
beaurocratic	bureaucratic
psycology	psychology
yeras	years
pich	pitch
obstacal	obstacle
faught	fought
critisizes	criticises
subtances	substances
manoeuverability	maneuverability
heigher	higher
expell	expel
altho	although
catagorized	categorized
strenous	strenuous
idesa	ides
iconclastic	iconoclastic
therby	thereby
htey	they
addtion	addition
assasinates	assassinates
foriegn	foreign
independance	independence
tyrrany	tyranny
accension	ascension
intergration	integration
amung	among
comapany	company
Fransiscan	Franciscan
competiveness	competitiveness
dessicated	desiccated
agressive	aggressive
persuded	persuaded
definit	definite
funguses	fungi
admendment	amendment
wherease	whereas
ciriculum	curriculum
noteriety	notoriety
seldomly	seldom
archeaologist	archeologist
jstu	just
formallized	formalized
monolite	monolithic
refered	referred
reffered	referred
achievments	achievements
unconfortability	discomfort
pwoer	power
maintainance	maintenance
praries	prairies
vehicule	vehicle
begginer	beginner
equialent	equivalent
speach	speech
inseperable	inseparable
knive	knife
recuiting	recruiting
majoroty	majority
techiniques	techniques
surveilence	surveillance
pursuades	persuades
attributred	attributed
embezelled	embezzled
gerat	great
alochol	alcohol
purpotedly	purportedly
guranteed	guaranteed
unsuprised	unsurprised
sideral	sidereal
ansestors	ancestors
imediately	immediately
sucidial	suicidal
helment	helmet
Peloponnes	Peloponnesus
Eurpean	European
thigns	things
parrakeets	parakeets
meterology	meteorology
activly	actively
throught	throughout
leathal	lethal
volounteering	volunteering
caluclated	calculated
ocurr	occur
quantitiy	quantity
expeiments	experiments
ubiquitious	ubiquitous
refridgeration	refrigeration
intenational	international
cxan	cyan
omiting	omitting
lavae	larvae
certian	certain
mischievious	mischievous
fontrier	fontier
acheived	achieved
subjudgation	subjugation
maintainence	maintenance
manufature	manufacture
possable	possible
persue	pursue
embarrasing	embarrassing
consentrated	concentrated
creedence	credence
transcendentational	transcendental
witn	with
doesnt	doesn't
veyr	very
distrubution	distribution
delapidated	dilapidated
interelated	interrelated
headquarer	headquarter
dacquiri	daiquiri
incomptable	incompatible
upgradded	upgraded
consitution	constitution
persuit	pursuit
forfiet	forfeit
varities	varieties
adbandon	abandon
precentage	percentage
incorportaed	incorporated
essesital	essential
nickle	nickel
enduce	induce
formaly	formally
essentail	essential
comissioner	commissioner
whther	whether
alientating	alienating
immediatley	immediately
wnats	wants
oging	going
candidiate	candidate
coridal	cordial
throught	through
toubles	troubles
thoughout	throughout
neigbours	neighbors
noticable	noticeable
knowlege	knowledge
accomodated	accommodated
surounded	surrounded
morroco	morocco
originially	originally
preample	preamble
makse	makes
bankrupcy	bankruptcy
haev	heave
excact	exact
housr	house
cannonical	canonical
supose	suppose
frome	from
beautyfull	beautiful
playwrites	playwrights
pinapple	pineapple
inheritence	inheritance
ther	the
interbread	interbreed
suround	surround
stuggling	struggling
aborigene	aborigine
suppy	supply
reched	reached
criticists	critics
mear	wear
enviroments	environments
hospitible	hospitable
Michagan	Michigan
neigbour	neighbour
colaborations	collaborations
garantee	guarantee
unathorised	unauthorised
dependance	dependence
priciple	principle
socities	societies
subpecies	subspecies
villify	vilify
Skagerak	Skagerrak
efford	effort
crowm	crown
committments	commitments
geographicial	geographical
manouverability	manoeuverability
epidsodes	episodes
carrers	careers
ahppen	happen
necessiate	necessitate
definitly	definitely
rudimentatry	rudimentary
aganist	against
councellors	councilors
portuguease	portuguese
obstancles	obstacles
diferrent	different
remeber	remember
assymetrical	asymmetrical
poverful	powerful
corridoors	corridors
consentrates	concentrates
appartment	apartment
unplease	displease
dominent	dominant
austrailia	Australia
holliday	holiday
catagories	categories
collecton	collection
aprehensive	apprehensive
sucessot	successor
deffine	define
acquiantence	acquaintance
exhibtion	exhibition
existince	existence
practial	practical
methaphors	metaphors
higway	highway
recide	reside
earlies	earliest
reccomending	recommending
assasination	assassination
wholy	holy
shorly	shortly
rememberance	remembrance
sepulcre	sepulcher
diaster	disaster
pavillion	pavilion
intrusted	entrusted
unihabited	uninhabited
involvment	involvement
embarrasment	embarrassment
unsed	unsaid
decendant	descendant
contaiminate	contaminate
sypmtoms	symptoms
interrugum	interregnum
religously	religiously
equivelant	equivalent
compulsery	compulsory
freindly	friendly
occurences	occurrences
univesity	university
sytem	system
surprizingly	surprisingly
tje	the
challange	challenge
Febuary	February
Portugese	Portuguese
acomplishment	accomplishment
owrk	work
componant	component
vigilence	vigilance
desparate	desperate
reccommended	recommended
ressurection	resurrection
consern	concern
prepair	prepare
bilateraly	bilaterally
spritual	spiritual
possably	possibly
protoganist	protagonist
micoscopy	microscopy
ganster	gangster
smoe	some
towords	towards
insurence	insurance
Cambrige	Cambridge
jewllery	jewellery
uise	use
expropiated	expropriated
gaurenteed	guaranteed
dimentions	dimensions
ommiting	omitting
illegitmate	illegitimate
restaraunt	restaurant
dramtic	dramatic
Guiness	Guinness
prouncements	pronouncements
unviersity	university
stingent	stringent
galvinized	galvanized
nutritents	nutrients
archictect	architect
cognizent	cognizant
invertibrates	invertebrates
diablical	diabolical
cannotation	connotation
prologomena	prolegomena
anohter	another
collonade	colonnade
imaginery	imagery
recidents	residents
warrent	warrant
efficent	efficient
contamporary	contemporary
almsot	almost
wich	which
strat	start
compatiblity	compatibility
sinse	sines
delerious	delirious
commemerative	commemorative
liason	liaison
suprized	surprised
paraphenalia	paraphernalia
controlls	controls
dalmation	dalmatian
hstory	history
acccused	accused
intepretation	interpretation
interpet	interpret
spectauclar	spectacular
negociation	negotiation
excecutes	executes
mchanics	mechanics
inbalance	imbalance
unweildly	unwieldy
occurance	occurrence
succeded	succeeded
volounteers	volunteers
disatisfied	dissatisfied
secratary	secretary
excisted	existed
surreptiously	surreptitiously
twpo	two
inot	into
lippizaner	lipizzaner
dissapears	disappears
momento	memento
dispence	dispense
hounour	honour
strenghten	strengthen
releived	relieved
essense	essence
orginize	organise
adquiring	acquiring
agricuture	agriculture
Carribean	Caribbean
incompatiblities	incompatibilities
doub	doubt
Ceasar	Caesar
afficionados	aficionados
claimes	claims
vaccume	vacuum
eleminating	eliminating
ahev	have
jsut	just
minstries	ministries
consectutive	consecutive
runing	running
impecabbly	impeccably
subsquently	subsequently
petetion	petition
heroe	hero
circulaton	circulation
consdidered	considered
teh	the
unwieldly	unwieldy
abondon	abandon
safty	safety
positon	positron
emition	emotion
galatic	galactic
Foundland	Newfoundland
asteriod	asteroid
retalitated	retaliated
moeny	money
sohw	show
gaurantee	guarantee
chasr	chase
chasr	chaser
perhpas	perhaps
presidenital	presidential
ammendments	amendments
constinually	continually
fiel	field
resteraunt	restaurant
orignially	originally
potrait	portrait
commerical	commercial
munbers	numbers
forbad	forbade
exectued	executed
responsability	responsibility
octohedron	octahedron
abortificant	abortifacient
indipendence	independence
rythmic	rhythmic
preliferation	proliferation
lisense	license
enlargment	enlargement
controled	controlled
historicians	historians
comander	commandeer
surviver	survivor
percepted	perceived
intevene	intervene
accordian	accordion
decendents	descendants
milennium	millennium
achive	achieve
Nuremburg	Nuremberg
emmisarry	emissary
discribing	describing
ansalisation	nasalisation
marmelade	marmalade
relevent	relevant
messanger	messenger
puting	putting
issueing	issuing
trafficing	trafficking
leanr	leaner
feasable	feasible
rythem	rhythm
alusion	illusion
imanent	imminent
sucesses	successes
reconnaissence	reconnaissance
temperture	temperature
suplimented	supplemented
controvery	controversy
admissability	admissibility
councellor	councillor
oppossed	opposed
unrepetant	unrepentant
willingless	willingness
acadmic	academic
aparent	apparent
critized	criticized
liesure	leisure
movei	movie
sargeant	sergeant
shreak	shriek
succsess	success
mathmaticians	mathematicians
altough	although
neigbouring	neighboring
uneccesary	unnecessary
voleyball	volleyball
singsog	singsong
masterbation	masturbation
florescent	fluorescent
comision	commission
satelites	satellites
supplamented	supplemented
erally	really
independantly	independently
aquired	acquired
miscelaneous	miscellaneous
exagerrates	exaggerates
chariman	chairman
responsibilites	responsibilities
vaguaries	vagaries
specfic	specific
commongly	commonly
fufill	fulfill
perjery	perjury
temerature	temperature
pomotion	promotion
mamal	mammal
binominal	binomial
tiem	time
demographical	demographic
synphony	symphony
recogise	recognise
suprise	surprise
Philipines	Philippines
gogin	going
appart	apart
deparmental	departmental
avalance	avalanche
settlment	settlement
amke	make
ened	need
steriods	steroids
satrically	satirically
wriet	write
owudl	would
resaurant	restaurant
happended	happened
presitgious	prestigious
imprisonned	imprisoned
sacreligious	sacrilegious
commemmorate	commemorate
obssessed	obsessed
equivilent	equivalent
possibile	possible
disricts	districts
acustom	accustom
unacompanied	unaccompanied
listners	listeners
denegrating	denigrating
govornment	government
infalability	infallibility
exagerated	exaggerated
hierachy	hierarchy
censur	censure
baout	bout
resembelance	resemblance
fiels	feels
Brittish	British
contruction	construction
tjhe	the
paliamentarian	parliamentarian
generatting	generating
particulary	particularly
aircaft	aircraft
mispelling	misspelling
mischevious	mischievous
tyhat	that
catergorize	categorize
lefted	left
interferance	interference
succesfully	successfully
commuications	communications
desorder	disorder
mosture	moisture
Palistinian	Palestinian
yearm	year
mysterous	mysterious
excellant	excellent
harrassed	harassed
iminent	eminent
annuled	annulled
moleclues	molecules
buring	burying
moderm	modem
noticably	noticeably
beacuse	because
intruduced	introduced
slaugterhouses	slaughterhouses
guage	gauge
ultimely	ultimately
clasic	classic
identicial	identical
recogize	recognize
undetecable	undetectable
playwrite	playwright
pronomial	pronominal
mear	mere
Saterday	Saturday
polution	pollution
enviromental	environmental
coudl	could
conesencus	consensus
responisble	responsible
demenor	demeanor
succsessfull	successful
absolutly	absolutely
vulnerablility	vulnerability
infallable	infallible
erally	orally
assertation	assertion
expecially	especially
unsucessfully	unsuccessfully
smae	same
inadiquate	inadequate
guarentees	guarantees
agreeement	agreement
thiunk	think
testiclular	testicular
wich	witch
dispencing	dispensing
noth	north
assosication	assassination
responsibile	responsible
dimenions	dimensions
govement	government
convential	conventional
dosen't	doesn't
possiblities	possibilities
imigration	emigration
populare	popular
curch	church
grafitti	graffiti
identifers	identifiers
proclamed	proclaimed
recrational	recreational
saftey	safety
relized	realised
synagouge	synagogue
allopone	allophone
critizing	criticizing
theives	thieves
controveries	controversies
incorruptable	incorruptible
subcatagories	subcategories
informtion	information
bemusemnt	bemusement
unsuprized	unsurprised
widesread	widespread
sicne	since
revaluated	reevaluated
fundametals	fundamentals
paide	paid
surprizing	surprising
unsuccesful	unsuccessful
ocuntries	countries
oppositition	opposition
Hallowean	Hallowe'en
vistors	visitors
firends	friends
conciousness	consciousness
eyasr	eyas
simultanous	simultaneous
beseiging	besieging
indespensible	indispensable
applicaitons	applications
becasue	because
suppoed	supposed
hapening	happening
aparment	apartment
conservitive	conservative
engieneer	engineer
labled	labeled
unprecendented	unprecedented
incompatablity	incompatibility
mediterainnean	mediterranean
negociate	negotiate
unequalities	inequalities
critisising	criticising
substituded	substituted
lonly	only
signitory	signatory
tremelo	tremolo
weild	wield
despict	depict
phongraph	phonograph
techicians	technicians
austrailian	Australian
accordeon	accordion
communiation	communication
attemp	attempt
incorperation	incorporation
streemlining	streamlining
predecesors	predecessors
delusionally	delusively
polyphonyic	polyphonic
levetating	levitating
diconnects	disconnects
authrorities	authorities
practicioners	practitioners
priveliges	privileges
maked	marked
theese	these
reenforced	reinforced
advesary	adversary
extrordinarily	extraordinarily
agains	against
countains	contains
sould	could
filiament	filament
clera	sclera
Dardenelles	Dardanelles
chemcially	chemically
inadvertant	inadvertent
endevour	endeavour
corrispondant	correspondent
rebllions	rebellions
priveleges	privileges
alledgedly	allegedly
inproving	improving
inmigrants	immigrants
newletters	newsletters
writen	written
precice	precise
consequentually	consequently
naturually	naturally
sotyr	satyr
parrallel	parallel
indite	indict
leanr	learn
hvea	heave
volonteer	volunteer
thikns	thinks
hten	hen
coctail	cocktail
boundry	boundary
compatiblities	compatibilities
stainlees	stainless
elementay	elementary
commmemorated	commemorated
emmiting	emitting
parliment	parliament
architechture	architecture
seperation	separation
curriculem	curriculum
acustommed	accustomed
abondoned	abandoned
hting	thing
infered	inferred
dowloads	downloads
leanr	lean
comando	commando
rythyms	rhythms
proffesor	professor
attemted	attempted
satric	satiric
succeds	succeeds
ingreediants	ingredients
litterally	literally
ocuntry	country
maked	made
expalin	explain
repatition	repetition
dissapearance	disappearance
geneological	genealogical
markes	marks
admininistrative	administrative
internation	international
permanant	permanent
plausable	plausible
fougth	fought
contamporaries	contemporaries
virutal	virtual
intervines	intervenes
noteably	notably
sophicated	sophisticated
whith	with
diphtongs	diphthongs
unoticeable	unnoticeable
stubborness	stubbornness
Postdam	Potsdam
belived	believed
attitide	attitude
norhern	northern
rhytmic	rhythmic
fiel	file
heared	heard
inevititably	inevitably
acheivment	achievement
excedded	exceeded
muscial	musical
seperate	separate
recided	resided
intially	initially
godesses	goddesses
abritrary	arbitrary
yeasr	years
visting	visiting
irelevent	irrelevant
alledges	alleges
disappearred	disappeared
lvoe	love
possessess	possesses
legitamate	legitimate
eiter	either
arival	arrival
excercise	exercise
comemmorates	commemorates
relaly	really
htere	there
harrasing	harassing
relient	reliant
ciricuit	circuit
facilites	facilities
diamons	diamonds
twelth	twelfth
causalities	casualties
optmizations	optimizations
drnik	drink
consolodated	consolidated
worls	world
substraction	subtraction
libell	libel
regulaion	regulation
forhead	forehead
eventally	eventually
instutionalized	institutionalized
becuase	because
claer	clear
bizzare	bizarre
inpeach	impeach
stange	strange
avation	aviation
rucuperate	recuperate
diea	die
esential	essential
mailny	mainly
extention	extension
philosphy	philosophy
orded	ordered
recurrance	recurrence
miltary	military
neigborhood	neighborhood
exagerates	exaggerates
coorperation	corporation
absorbsion	absorption
busness	business
indefineable	undefinable
hypocricy	hypocrisy
terrestial	terrestrial
posessions	possessions
cerimonious	ceremonious
accademic	academic
typcial	typical
penninsular	peninsular
missen	mizzen
briliant	brilliant
prestigeous	prestigious
surrended	surrendered
armamant	armament
eligable	eligible
monickers	monikers
proclaming	proclaiming
bouyancy	buoyancy
inumerable	innumerable
afair	affair
aproximately	approximately
ganes	games
juristiction	jurisdiction
subconsiously	subconsciously
incompetant	incompetent
contributers	contributors
althought	although
cellpading	cellpadding
Massachussets	Massachusetts
boyant	buoyant
whcih	which
indulgue	indulge
conviced	convinced
challanged	challenged
sovereignity	sovereignty
degrate	degrade
thta	that
politican	politician
cheif	chief
prepartion	preparation
withold	withhold
sieze	size
controversal	controversial
asetic	ascetic
formidible	formidable
adolecent	adolescent
corrisponds	corresponds
candiate	candidate
archaelogists	archaeologists
happend	happened
analagous	analogous
wroking	working
airrcraft	aircraft
plantiff	plaintiff
insitutions	institutions
soverignity	sovereignty
typicaly	typically
phillosophically	philosophically
reguarly	regularly
hypocrits	hypocrites
soverignty	sovereignty
protruberance	protuberance
symmetricaly	symmetrically
disapeared	disappeared
inbalanced	imbalanced
strenghtened	strengthened
acommodate	accommodate
govermental	governmental
hierarcical	hierarchical
amoungst	amongst
fonetic	phonetic
charactors	characters
pennisula	peninsula
vigeur	vigor
sufferred	suffered
confidentally	confidentially
healthercare	healthcare
ammended	amended
eminate	emanate
occaison	occasion
collonies	colonies
irresistable	irresistible
adquired	acquired
addopted	adopted
tepmorarily	temporarily
polinator	pollinator
pertubation	perturbation
lattitude	latitude
proclomation	proclamation
